----------------------------------------
verify these items with a native speaker
----------------------------------------
CH11
aghulaqe@~:(i/u)ma[V.V][Intr][Ptcp][3Sg]	aghulaqumaka
aqlaghate[Intr][Ptcp][3Sg]	aqlaghalka
esghagh@~:(i/u)ma[V.V][Trns][Ptcp][3Sg][1Sg]	esghaamakaanga
esghagh[Trns][Ptcp][1Sg][2Sg]	esghaqemken
kayusigh[Trns][Ptcp][2Sg][1Sg]	kayusiqavnga
kiyaghte@~:(i/u)ma[V.V][Intr][Ptcp][3Sg]	kiyaghsimaka
neghe[Intr][Ptcp][1Pl]	neghelghiikut
neghe@~:(i/u)ma[V.V][Intr][Ptcp][1Sg]	neghumakanga
neghe@~:(i/u)ma[V.V][Intr][Ptcp][2Sg]	neghumakaten
neghe@~:(i/u)ma[V.V][Intr][Ptcp][3Pl]	neghumakat
neghe@~:(i/u)ma[V.V][Intr][Ptcp][3Sg]	neghumaka
neghe@~:(i/u)ma[V.V][Trns][Ptcp][1Sg][3Sg]	neghumakagka
neghe@~:(i/u)ma[V.V][Trns][Ptcp][2Sg][3Sg]	neghumakan
qepghagh~(g)aqe[V.V][Intr][Ptcp][3Sg]	qepghaghaqegka

CH12
iggag[QuantQual][4Sg]-ete[Intr][Ptcp][3Sg]	iggagmelka

CH13
igatagh@–nghite[V.V][Intr][Conc][1Pl]	igatanghiteghngaamta

CH14
ukig@~f–ragkiigh[V.V][Intr][Ind][3Sg]	ukigragkiightuq
amqeghte[Intr][CnsqI][3Sg]	amqeghtengan
neghe@–nghite[V.V][Intr][CnsqI][3Sg]	neghenghitngan
sukate[Intr][CnsqI][3Sg]	?
taaqe[Intr][Cond][3Sg]	taaqkan
4Du alternative forms for Conditional mood (p.92)
