aqume-      Noun; ! 	to sit (intransitive only)
egte-      Noun; ! 	to throw away (transitive only)
esnae      Noun; ! 	shore; rim
esnaq      Noun; ! 	beach
igaghyaghqaq      Noun; ! 	paper to be written on
igaq      Noun; ! 	paper with writing (in plural book)
kaamwaaq      Noun; ! 	coltsfoot plant (Petasites frigidus)
kaaw-      Noun; ! 	to hit, to strike with an object (transitive or intransitive)
kenigh-      Noun; ! 	to point (at) (transitive only)
lata-      Noun; ! 	to write a letter (to) (transitive or intransitive)
legan      Noun; ! 	go ahead; and then (particle)
nalighmeng      Noun; ! 	or (particle)
nanglii-      Noun; ! 	to stare into space (intransitive only)
nekeve-      Noun; ! 	to stand up (intransitive only)
nekrek      Noun; ! 	hook
pugimagh-      Noun; ! 	to swim (transitive or intransitive)
puugzaq      Noun; ! 	beluga
pumsug-      Noun; ! 	to pinch (transitive only)
qayugh-      Noun; ! 	to drink hot liquid (coffee, tea, etc.) (intransitive only)
qayuusiq      Noun; ! 	cup
quuk      Noun; ! 	swan
quuk      Noun; ! 	firewood (homophonous with preceding word)
ququngaq      Noun; ! 	leaf; edible willow leaf
unkusae      Noun; ! 	animal trap (usually dual for one trap)
taaghta      Noun; ! 	doctor (base is taaghta-)
tagite-      Noun; ! 	to bring here (transitive only)
tuqute-      Noun; ! 	to kill (transitive only)
