neghe(V)^@~fna(V→V)^[Sbrd.Intr]^[3Sg]	neghnaluni
kuuve(V)^@~fna(V→V)^[Sbrd.Trns]^[_.3Sg]	kuuvnaluku
tuqute(V)^@~fna(V→V)^[Sbrd.Trns]^[_.3Pl]	tuqunnaluki
laalighte(V)^@~fna(V→V)^[Sbrd.Intr]^[3Sg]	laalighhnaluni
atugh(V)^@~fna(V→V)^[Sbrd.Trns]^[_.3Sg]	atughnaluku
aane(V)^@~fna(V→V)^[Sbrd.Trns]^[_.3Sg]	aanaluni
qavagh(V)^@~fna(V→V)^[Sbrd.Intr]^[3Sg]	qavaghnaluni
aglagh(V)^@~fna(V→V)^[Sbrd.Intr]^[1Sg]	aglaghnalunga
meghnaali(V)^@~fna(V→V)^[Sbrd.Intr]^[3Du]	meghnaalinalutek
qavagh(V)^@~fna(V→V)^[Sbrd.Intr]^[2Du]	qavaghnalutek
yimi(EMO)^@~fnagh(EMO→V)^[Ind.Intr]^[3Sg]	yiminaghtuq
igamsiqa(EMO)^@~fnagh(EMO→V)^[Ind.Intr]^[3Sg]	yiminaghtuq
nallu(V)^@~fnagh(V→V)^[Ind.Intr]^[3Sg]	nallunaghtuq
nenglagh(V)^@~fnagh(V→V)^[Ind.Intr]^[3Sg]	nenglaghnaghtuq
tuqu(V)^@~fnagh(V→V)^[Ind.Intr]^[3Sg]	tuqunaghtuq
uguqe(V)^@~fnagh(V→V)^[Ind.Intr]^[3Sg]	uguqnaghtuq
tagi(V)^@~fnaagh(V→V)^[Ind.Intr]^[3Sg]	taginaaghtuq
ingaghte(V)^@~fnaagh(V→V)^[Ind.Intr]^[3Sg]	ingaghhnaaghtuq
kaate(V)^@~fnaagh(V→V)^[Ind.Intr]^[3Sg]	kaannaaghtuq
tuqu(V)^@~fnaanghite(V→V)^[Ind.Intr]^[3Sg]	tuqunaanghituq
neghe(V)^@~fnaanghite(V→V)^[Ind.Trns]^[3Sg.3Sg]	neghnaanghitaa
tuqute(V)^@~fnaanghite(V→V)^[Ind.Trns]^[1Sg.3Pl]	tuqunnaanghitanka
neghe(V)^@~fyug(V→V)^@~fnaanghite(V→V)^[Ind.Intr]^[3Sg]	neghyugnaanghituq
qepghagh(V)^@~fnanigh(V→V)^[Ind.Intr]^[3Sg]	qepghaghnanightuq
yughagh(V)^@~fnanigh(V→V)^[Ind.Intr]^[3Sg]	yughaghnanightuq
kuuve(V)^@~fnanigh(V→V)^[Ind.Trns]^[3Sg.3Sg]	kuuvnanighaa
qalleg(V)^@~fnanighqe(V→V)^[Ind.Trns]^[3Sg.3Sg]	qallegnanighqaa
sa(V)^@~fnanighqe(V→V)^[Ind.Trns]^[3Sg.3Sg]	sananighqaa
aklu(V)^@~fnagh(V→N)^[Abs.Sg]	aklunaq
yimi(EMO)^@~fnagh(EMO→N)^[Abs.Sg]	yiminaq
iyatagh(V)^@~fnagh(V→N)^[Abs.Sg]	iyataghnaq
igatagh(V)^@~fnagh(V→N)^[Abs.Sg]	igataghnaq
kaleve(V)^@~fnagh(V→N)^[Abs.Sg]	kalevnaq	
kasug(V)^@~fnagh(V→N)^[Abs.Sg]	kasugnaq
nanghha(V)^@~fnagh(V→N)^[Abs.Sg]	nangghanaq
nenglagh(V)^@~fnagh(V→N)^[Abs.Sg]	nenglaghnaq
pallugte(V)^@~fnagh(V→N)^[Abs.Sg]	palluggnaq
qaasni(V)^@~fnagh(V→N)^[Abs.Sg]	qaasninaq
neqete(V)^@~fnaqe(V→N)^[Abs.Sg]	neqennaqa
qimugsigh(N)^@~fnaqe(V→N)^[Abs.Pl]	qimugsighnaqet
unkuseniigh(N)^@~fyagh(V→V)^@~fnaqe(V→N)^[Abs.Sg]	unkuseniighyaghnaqa
taaqe(V)^@~fnaqe(V→V)^[Ind.Intr]^[3Sg]	taaqnaquq
kaate(V)^@~fnaqe(V→V)^[Ind.Intr]^[3Sg]	kaannaquq
qavagh(V)^@~fnaqe(V→V)^[Ind.Intr]^[3Sg]	qavaghnaquq
kete(V)^@~fnaqe(V→V)^[Ind.Intr]^[3Sg]	kennaquq
aane(V)^@~fnaqe(V→V)^[Ind.Intr]^[3Sg]	aanaquq
aate(V)^@~fnaqe(V→V)^[Ind.Intr]^[3Sg]	aannaquq
tagi(V)^@~fnaqelqusiigh(V→V)^[Ind.Intr]^[3Sg]	taginaqelqusiightuq
qiya(V)^@~fnaqlaatagh(V→V)^[Ind.Intr]^[3Sg]	qiyanaqlaataghtuq
eltekeltagh(V)^@~fnaqlaatagh(V→V)^[Ind.Intr]^[3Sg]	eltekeltaghnaqlaataghtuq
kiyaghte(V)^@~fnaqlaatagh(V→V)^[Ind.Intr]^[1Pl]	kiyaghhnaqlaataghtukut
tuqusiigh(V)^@~fnaqngu(V→V)^@–nghite(V→V)^[Cond.Intr]^[1Pl]	tuqusiighnaqngunghilkumta
tuqusiigh(V)^@~fnaqngu(V→V)^@–nghite(V→V)^[Cond.Intr]^[1Pl]	tuqusiighnaqngunghiskumta
tuqusiigh(V)^@~fnaqngu(V→V)^@–nghite(V→V)^[Cond.Intr]^[1Pl]	tuqusiighnaqngunghitkumta
atugh(V)^@~fnaqutke(V→V)^[Ind.Intr]^[3Sg]	atughnaqutkuq
kuuve(V)^@~fnaqutke(V→V)^[Ind.Trns]^[3Sg.3Sg]	kuuvnaqutkaa
tuune(V)^@~fnaqutke(V→V)^[Ind.Trns]^[3Sg.3Sg]	tuunaqutkaa
teghtugh(V)^@~fnasiigh(V→V)^[Ind.Intr]^[3Sg]	teghtughnasiightuq
negh(V)^@~fnasiigh(V→V)^[Ind.Intr]^[3Sg]	neghnasiightuq
qepghagh(V)^@~fnasiigh(V→V)^[Ind.Intr]^[3Sg]	qepghanasiightuq
quynginge(V)^@~fnatke(V→V)^@~:(i/u)ma(V→V)^~(g)aqe(V→V)^[Ptcp.Trns]^[3Pl.3Sg]	quyngingnatkumaaqegkangat
pi(V)^@~fnayagh(V→V)^[Ind.Trns]^[1Sg.3Sg]	pinayaghaqa
neghe(V)^@~fnayagh(V→V)^@–nghite(V→V)^[Ind.Intr]^[1Sg]	neghnayanghitunga
pi(V)^@~f–neghllug(V→V)^[Ind.Intr]^[3Sg]	pineghllugtuq
tusaqe(V)^@~f–neghllug(V→V)^[Ind.Intr]^[3Sg]	tusaqneghllugtuq
negh(N)^@~f–neghllug(V→N)^[Abs.Sg]	neneghlluk
aaghte(V)^@~f–neghllug(V→N)^[Abs.Sg]	aaghhneghlluk
piite(V)^@~f–neghsigh(V→V)^~(g)aqe(V→V)^[Ind.Trns]^[3Pl.3Sg]	piinneghsighaqaat
yughagh(V)^@~f–neghtu(V→V)^[Ind.Intr]^[3Sg]	yughaneghtuuq
nuqete(V)^@~f–neghtu(V→V)^[Ind.Intr]^[3Sg]	nuqenneghtuuq
qiya(V)^@~f–negh(V→N)^[Abs.Sg]	qiyaneq
kumlate(V)^@~f–negh(V→N)^[Abs.Sg]	kumlanneq
ikighte(V)^@~f–negh(V→N)^[Abs.Sg]	ikighhneq
qavagh(V)^@~f–negh(V→N)^[Abs.Sg]	qavaneq
aveg(V)^@~f–negh(V→N)^[Abs.Sg]	aveneq
negh(V)^@~f–negh(V→N)^[Abs.Sg]	neneq
kuuve(V)^@~f–negh(V→N)^[Abs.Sg]	kuuveneq
negh(V)^@~f–negh(V→N)^[Abl_Mod.Sg]	neneghmeng
naalke(V)^@~f–negh(V→N)^[Abl_Mod.Sg]	naalkenneghmeng
agla(V)^@~f–negh(V→N)^[Abl_Mod.Sg]	aglaneghmeng
aange(V)^@~f–negh(V→N)^[Abs.Pl]	aangenghat
aange(V)^@~f–negh(V→N)^[Abs.Pl]	aangenghit
ingagh(POS)^+nga(POS→V)^[Ind.Intr][3Sg]	ingaghngaaq
kepe(V)^~fnga(POS→V)^[Ind.Intr][3Sg]	kepngaaq
liite(V)^~fnga(V→V)^[Ind.Intr][3Sg]	liitngaaq
aveg(V)^~fnga(V→V)^[Ind.Intr][3Sg]	avegngaaq
atkug(V)^~fnga(V→V)^[Ind.Intr][3Sg]	atkugngaaq
nasaperagh(V)^~fnga(V→V)^[Ind.Intr][3Sg]	nasaperaghngaaq
piifte(V)^~fnga(V→V)^[Ind.Intr][3Sg]	piivngaaq
piiste(V)^~fnga(V→V)^[Ind.Intr][3Sg]	piizngaaq
qiwaagh(V)^~fnga(V→V)^[Ind.Intr][3Sg]	qiwaaghngaaq
nuna(N)^–nge(N→V)^[Ind.Intr]^[3Sg]	nunanguq
neqe(N)^–nge(N→V)^[Ind.Intr]^[3Sg]	neqenguq
ggute(N)^–nge(N→V)^[Ind.Intr]^[3Sg]	ggutenguq
qikmigh(N)^–nge(N→V)^[Ind.Intr]^[3Sg]	qikminguq
ategh(N)^–nge(N→V)^[Ind.Intr]^[3Sg]	atenguq
aghvegh(N)^–nge(N→V)^@~–(g)kau(V→V)^[Ind.Intr]^[1Pl]	aghvengegkaagukut
nenglagh(V)^–ngestagh(N→V)^[Ind.Intr]^[3Sg]	nenglangestaghtuq
nenglagh(V)^–ngestagh(N→V)^[Ind.Intr]^[3Sg]	nenglengestaghtuq
qayugh(V)^–ngestagh(N→V)^[Ind.Intr]^[3Sg]	qayungestaghtuq
qayugh(V)^–ngestagh(N→V)^[Ind.Intr]^[3Sg]	qayengestaghtuq
angyagh(N)^–ngestagh(N→N)^[Abs.Sg]	angyangestaq
angyagh(N)^–ngestagh(N→N)^[Abs.Sg]	angyengestaq
mangteghagh(N)^–ngestagh(N→N)^[Abs.Sg]	mangteghangestaq
mangteghagh(N)^–ngestagh(N→N)^[Abs.Sg]	mangteghengestaq
saguyagh(N)^–ngestagh(N→N)^[Abs.Sg]	saguyangestaq
saguyagh(N)^–ngestagh(N→N)^[Abs.Sg]	saguyengestaq
saguyagh(N)^–ngestagh(N→N)^[Abs.Sg]	segeyengestaq
aglagh(V)^–@nghaagh(V→N)^[Abs.Sg]	aglanghhaq
angli(V)^–@nghaagh(V→N)^[Abs.Sg]	anglinghhaq
sii(V)^–@nghaagh(V→N)^[Abs.Sg]	siinghhaq
kaate(V)^–@nghaagh(V→N)^[Abs.Sg]	kaanneghhaq
qavagh(V)^@–nghiighte(V→V)^[Ind.Intr]^[3Sg]	qavanghiightuq
neghe(V)^@–nghiighte(V→V)^[Ptcp.Trns]^[2Sg.3Sg]	neghenghiightekan
qiya(V)^@–nghite(V→V)^[Ind.Intr]^[3Sg]	qiyanghituq
neghe(V)^@–nghite(V→V)^[Ind.Intr]^[3Sg]	neghenghitaa
qavagh(V)^@–nghite(V→V)^[Ind.Intr]^[3Sg]	qavanghituq
itegh(V)^@–nghite(V→V)^[Ind.Intr]^[3Sg]	itenghituq
kaate(V)^@–nghite(V→V)^[Ind.Intr]^[3Sg]	kaanneghituq
ingaghte(V)^@–nghite(V→V)^[Ind.Intr]^[3Sg]	ingaghhneghituq
negh(V)^@~:(ng)igate(V→V)^[Ind.Trns]^[3Sg.3Sg]	neghigatii
qavagh(V)^@~:(ng)igate(V→V)^[Ind.Intr]^[3Sg]	qaviigatuq
negh(V)^@~fyug(V→V)^@~:(ng)igate(V→V)^[Ind.Trns]^[1Sg.3Pl]	neghyugigatanka
itegh(V)^@~:(ng)igate(V→V)^[Ind.Intr]^[3Sg]	iitghigatuq
taaqe(V)^@~:(ng)igate(V→V)^[Ind.Intr]^[3Sg]	taaqigatuq
qiya(V)^@~:(ng)igate(V→V)^[Ind.Intr]^[3Sg]	qiyangigatuq
laalighte(V)^@~:(ng)igate(V→V)^[Ind.Trns]^[3Sg.1Sg]	laalighsigataanga
kaate(V)^@~:(ng)igate(V→V)^[Ind.Intr]^[3Sg]	kaasigatut
