(Chewing Gum Note)

chewing	+?

gum	+?

note	+?

------------------------


------------------------
Ayungkaghangllaghaqut upenghami salin nuna anigulguluku.

ayungkaghangllaghaqut	+?

upenghami	+?

salin	+?

nuna	nuna[N][Abs][Unpd][Sg]

anigulguluku	+?

------------------------
Meghutlugkwaaghhaat nanim ellngaatnganeng imighluki laagutaaqiit nunakun anigum tungangakun.

meghutlugkwaaghhaat	+?

nanim	+?

ellngaatnganeng	+?

imighluki	+?

laagutaaqiit	+?

nunakun	nuna-~–ke[to.have.as.one's.N(s)][N→V]-~:(u)te[condition.with.respect.to.V-ing][V→N][N][Abs][Unpd][Sg]
nunakun	nuna[N][Via][Unpd][Sg]

anigum	anigu[N][Rel][Unpd][Sg]

tungangakun	+?

------------------------
Taam meghutlugwem piizngallghan paayngi uzimun qiighluki kumaghtaqiit.

taam	+?

meghutlugwem	+?

piizngallghan	+?

paayngi	paye[N][Abs][3SgPoss][PlPosd]

uzimun	+?

qiighluki	+?

kumaghtaqiit	+?

------------------------
Qiiqiinaghaqluki kumangastaaqiit kenlanga ellngaatet ilullghitnun, maatneghem kumaghneghaki.

qiiqiinaghaqluki	+?

kumangastaaqiit	+?

kenlanga	+?

ellngaatet	+?

ilullghitnun	+?

maatneghem	+?

kumaghneghaki	+?

------------------------
Enraghngam patellghitnun kumangasluki taagken anigumun kuuvaqiit nenglisqelluki.

enraghngam	+?

patellghitnun	+?

kumangasluki	+?

taagken	taagken

anigumun	anigu[N][Ter][Unpd][Sg]

kuuvaqiit	kuuve-~(g₁)aqe[to.be.V.ing][to.regularly.or.repeatedly.V][V→V]-~i[SBJ.V-ed.something][V→V][V][Intrg][3Pl]
kuuvaqiit	kuuve-~(g₁)aqe[to.be.V.ing][to.regularly.or.repeatedly.V][V→V]-~i[SBJ.V-ed.something][V→V][V][Ind][3Pl]
kuuvaqiit	kuuve-~(g₁)aqe[to.be.V.ing][to.regularly.or.repeatedly.V][V→V][V][Ind][3Pl][3Pl]
kuuvaqiit	kuuve-~(g₁)aqe[to.be.V.ing][to.regularly.or.repeatedly.V][V→V][V][Ind][3Du][3Sg]

nenglisqelluki	+?

------------------------
Taakut anigumelnguut ayungkaghaagut.

taakut	taake[V][Ind][3Pl]

anigumelnguut	+?

ayungkaghaagut	+?

------------------------
