aaw[N][Abs][1DuPoss][DuPosd]	aawegpung
aaw[N][Abs][1DuPoss][PlPosd]	aapung
aaw[N][Abs][1DuPoss][SgPosd]	aawpung
aaw[N][Abs][1PlPoss][DuPosd]	aawegput
aaw[N][Abs][1PlPoss][PlPosd]	aaput
aaw[N][Abs][1PlPoss][SgPosd]	aawput
aaw[N][Abs][1SgPoss][DuPosd]	aawegka
aaw[N][Abs][1SgPoss][PlPosd]	aawenka
aaw[N][Abs][1SgPoss][SgPosd]	aakwa
aghnaghagh*[N][Abs][1DuPoss][DuPosd]	aghnaghaagpung
aghnaghagh*[N][Abs][1DuPoss][PlPosd]	aghnaghapung
aghnaghagh*[N][Abs][1DuPoss][SgPosd]	aghnaghaghpung
aghnaghagh*[N][Abs][1PlPoss][DuPosd]	aghnaghaagput
aghnaghagh*[N][Abs][1PlPoss][PlPosd]	aghnaghaput
aghnaghagh*[N][Abs][1PlPoss][SgPosd]	aghnaghaghput
aghnaghagh*[N][Abs][1SgPoss][DuPosd]	aghnaghaagka
aghnaghagh*[N][Abs][1SgPoss][PlPosd]	aghnaghaanka
aghnaghagh*[N][Abs][1SgPoss][SgPosd]	aghnaghaqa
angyagh[N][Abs][1DuPoss][DuPosd]	angyagpung
angyagh[N][Abs][1DuPoss][PlPosd]	angyapung
angyagh[N][Abs][1DuPoss][SgPosd]	angyaghpung
angyagh[N][Abs][1PlPoss][DuPosd]	angyagput
angyagh[N][Abs][1PlPoss][PlPosd]	angyaput
angyagh[N][Abs][1PlPoss][SgPosd]	angyaghput
angyagh[N][Abs][1SgPoss][DuPosd]	angyagka
angyagh[N][Abs][1SgPoss][PlPosd]	angyanka
angyagh[N][Abs][1SgPoss][SgPosd]	angyaqa
apa[N][Abs][1DuPoss][DuPosd]	apagpung
apa[N][Abs][1DuPoss][PlPosd]	apapung
apa[N][Abs][1DuPoss][SgPosd]	apavung
apa[N][Abs][1PlPoss][DuPosd]	apagput
apa[N][Abs][1PlPoss][PlPosd]	apaput
apa[N][Abs][1PlPoss][SgPosd]	apavut
apa[N][Abs][1SgPoss][DuPosd]	apagka
apa[N][Abs][1SgPoss][PlPosd]	apanka
apa[N][Abs][1SgPoss][SgPosd]	apaka
ata[N][Abs][1DuPoss][DuPosd]	atagpung
ata[N][Abs][1DuPoss][PlPosd]	atapung
ata[N][Abs][1DuPoss][SgPosd]	atavung
ata[N][Abs][1PlPoss][DuPosd]	atagput
ata[N][Abs][1PlPoss][PlPosd]	ataput
ata[N][Abs][1PlPoss][SgPosd]	atavut
ata[N][Abs][1SgPoss][DuPosd]	atagka
ata[N][Abs][1SgPoss][PlPosd]	atanka
ata[N][Abs][1SgPoss][SgPosd]	ataka
ategh[N][Abs][1DuPoss][DuPosd]	aatghegpung
ategh[N][Abs][1DuPoss][PlPosd]	atepung
ategh[N][Abs][1DuPoss][SgPosd]	ateghpung
ategh[N][Abs][1PlPoss][DuPosd]	aatghegput
ategh[N][Abs][1PlPoss][PlPosd]	ateput
ategh[N][Abs][1PlPoss][SgPosd]	ateghput
ategh[N][Abs][1SgPoss][DuPosd]	aatghegka
ategh[N][Abs][1SgPoss][PlPosd]	aatghenka
ategh[N][Abs][1SgPoss][SgPosd]	aatqa
avaqutagh[N][Abs][1DuPoss][DuPosd]	avaqutagpung
avaqutagh[N][Abs][1DuPoss][PlPosd]	avaqutapung
avaqutagh[N][Abs][1DuPoss][SgPosd]	avaqutaghpung
avaqutagh[N][Abs][1PlPoss][DuPosd]	avaqutagput
avaqutagh[N][Abs][1PlPoss][PlPosd]	avaqutaput
avaqutagh[N][Abs][1PlPoss][SgPosd]	avaqutaghput
avaqutagh[N][Abs][1SgPoss][DuPosd]	avaqutagka
avaqutagh[N][Abs][1SgPoss][PlPosd]	avaqutanka
avaqutagh[N][Abs][1SgPoss][SgPosd]	avaqutaqa
eltughagh*[N][Abs][1DuPoss][DuPosd]	eltughaagpung
eltughagh*[N][Abs][1DuPoss][PlPosd]	eltughapung
eltughagh*[N][Abs][1DuPoss][SgPosd]	eltughaghpung
eltughagh*[N][Abs][1PlPoss][DuPosd]	eltughaagput
eltughagh*[N][Abs][1PlPoss][PlPosd]	eltughaput
eltughagh*[N][Abs][1PlPoss][SgPosd]	eltughaghput
eltughagh*[N][Abs][1SgPoss][DuPosd]	eltughaagka
eltughagh*[N][Abs][1SgPoss][PlPosd]	eltughaanka
eltughagh*[N][Abs][1SgPoss][SgPosd]	eltughaqa
ggute[N][Abs][1DuPoss][DuPosd]	ggutegpung
ggute[N][Abs][1DuPoss][PlPosd]	ggutepung
ggute[N][Abs][1DuPoss][SgPosd]	ggutevung
ggute[N][Abs][1PlPoss][DuPosd]	ggutegput
ggute[N][Abs][1PlPoss][PlPosd]	gguteput
ggute[N][Abs][1PlPoss][SgPosd]	ggutevut
ggute[N][Abs][1SgPoss][DuPosd]	ggutegka
ggute[N][Abs][1SgPoss][PlPosd]	ggutenka
ggute[N][Abs][1SgPoss][SgPosd]	gguutka
ighnegh[N][Abs][1DuPoss][DuPosd]	ighneghegpung
ighnegh[N][Abs][1DuPoss][PlPosd]	ighnepung
ighnegh[N][Abs][1DuPoss][SgPosd]	ighneghpung
ighnegh[N][Abs][1PlPoss][DuPosd]	ighneghegput
ighnegh[N][Abs][1PlPoss][PlPosd]	ighneput
ighnegh[N][Abs][1PlPoss][SgPosd]	ighneghput
ighnegh[N][Abs][1SgPoss][DuPosd]	ighneghegka
ighnegh[N][Abs][1SgPoss][PlPosd]	ighneghenka
ighnegh[N][Abs][1SgPoss][SgPosd]	ighneqa
iigge[N][Abs][1DuPoss][DuPosd]	iiggegpung
iigge[N][Abs][1DuPoss][PlPosd]	iiggepung
iigge[N][Abs][1DuPoss][SgPosd]	iiggevung
iigge[N][Abs][1PlPoss][DuPosd]	iiggegput
iigge[N][Abs][1PlPoss][PlPosd]	iiggeput
iigge[N][Abs][1PlPoss][SgPosd]	iiggevut
iigge[N][Abs][1SgPoss][DuPosd]	iiggegka
iigge[N][Abs][1SgPoss][PlPosd]	iiggenka
iigge[N][Abs][1SgPoss][SgPosd]	iigka
iye[N][Abs][1DuPoss][DuPosd]	iyegpung
iye[N][Abs][1DuPoss][PlPosd]	iyepung
iye[N][Abs][1DuPoss][SgPosd]	iyevung
iye[N][Abs][1PlPoss][DuPosd]	iyegput
iye[N][Abs][1PlPoss][PlPosd]	iyeput
iye[N][Abs][1PlPoss][SgPosd]	iyevut
iye[N][Abs][1SgPoss][DuPosd]	iyegka
iye[N][Abs][1SgPoss][PlPosd]	iyenka
iye[N][Abs][1SgPoss][SgPosd]	iiska
kemeg[N][Abs][1DuPoss][DuPosd]	kemgegpung
kemeg[N][Abs][1DuPoss][PlPosd]	kemepung
kemeg[N][Abs][1DuPoss][SgPosd]	kemegpung
kemeg[N][Abs][1PlPoss][DuPosd]	kemgegput
kemeg[N][Abs][1PlPoss][PlPosd]	kemeput
kemeg[N][Abs][1PlPoss][SgPosd]	kemegput
kemeg[N][Abs][1SgPoss][DuPosd]	kemgegka
kemeg[N][Abs][1SgPoss][PlPosd]	kemgenka
kemeg[N][Abs][1SgPoss][SgPosd]	kemka
mekelghiigh[N][Abs][1DuPoss][DuPosd]	mekelghiighegpung
mekelghiigh[N][Abs][1DuPoss][PlPosd]	mekelghiipung
mekelghiigh[N][Abs][1DuPoss][SgPosd]	mekelghiighpung
mekelghiigh[N][Abs][1PlPoss][DuPosd]	mekelghiighegput
mekelghiigh[N][Abs][1PlPoss][PlPosd]	mekelghiiput
mekelghiigh[N][Abs][1PlPoss][SgPosd]	mekelghiighput
mekelghiigh[N][Abs][1SgPoss][DuPosd]	mekelghiighegka
mekelghiigh[N][Abs][1SgPoss][PlPosd]	mekelghiighenka
mekelghiigh[N][Abs][1SgPoss][SgPosd]	mekelghiiqa
mekestaaghhagh*[N][Abs][1DuPoss][DuPosd]	mekestaaghhaagpung
mekestaaghhagh*[N][Abs][1DuPoss][PlPosd]	mekestaaghhapung
mekestaaghhagh*[N][Abs][1DuPoss][SgPosd]	mekestaaghhaghpung
mekestaaghhagh*[N][Abs][1PlPoss][DuPosd]	mekestaaghhaagput
mekestaaghhagh*[N][Abs][1PlPoss][PlPosd]	mekestaaghhaput
mekestaaghhagh*[N][Abs][1PlPoss][SgPosd]	mekestaaghhaghput
mekestaaghhagh*[N][Abs][1SgPoss][DuPosd]	mekestaaghhaagka
mekestaaghhagh*[N][Abs][1SgPoss][PlPosd]	mekestaaghhaanka
mekestaaghhagh*[N][Abs][1SgPoss][SgPosd]	mekestaaghhaqa
naa[N][Abs][1DuPoss][DuPosd]	naagpung
naa[N][Abs][1DuPoss][PlPosd]	naapung
naa[N][Abs][1DuPoss][SgPosd]	naavung
naa[N][Abs][1PlPoss][DuPosd]	naagput
naa[N][Abs][1PlPoss][PlPosd]	naaput
naa[N][Abs][1PlPoss][SgPosd]	naavut
naa[N][Abs][1SgPoss][DuPosd]	naagka
naa[N][Abs][1SgPoss][PlPosd]	naanka
naa[N][Abs][1SgPoss][SgPosd]	naaka
ne[N][Abs][1DuPoss][DuPosd]	negpung
ne[N][Abs][1DuPoss][PlPosd]	nepung
ne[N][Abs][1DuPoss][SgPosd]	nevung
ne[N][Abs][1PlPoss][DuPosd]	negput
ne[N][Abs][1PlPoss][PlPosd]	neput
ne[N][Abs][1PlPoss][SgPosd]	nevut
ne[N][Abs][1SgPoss][DuPosd]	negka
ne[N][Abs][1SgPoss][PlPosd]	nenka
ne[N][Abs][1SgPoss][SgPosd]	neka
nengyugh*[N][Abs][1DuPoss][DuPosd]	nengyuugpung
nengyugh*[N][Abs][1DuPoss][PlPosd]	nengyupung
nengyugh*[N][Abs][1DuPoss][SgPosd]	nengyughpung
nengyugh*[N][Abs][1PlPoss][DuPosd]	nengyuugput
nengyugh*[N][Abs][1PlPoss][PlPosd]	nengyuput
nengyugh*[N][Abs][1PlPoss][SgPosd]	nengyughput
nengyugh*[N][Abs][1SgPoss][DuPosd]	nengyuugka
nengyugh*[N][Abs][1SgPoss][PlPosd]	nengyuunka
nengyugh*[N][Abs][1SgPoss][SgPosd]	nengyuqa
nuliigh[N][Abs][1DuPoss][DuPosd]	nuliighegpung
nuliigh[N][Abs][1DuPoss][PlPosd]	nuliipung
nuliigh[N][Abs][1DuPoss][SgPosd]	nuliighpung
nuliigh[N][Abs][1PlPoss][DuPosd]	nuliighegput
nuliigh[N][Abs][1PlPoss][PlPosd]	nuliiput
nuliigh[N][Abs][1PlPoss][SgPosd]	nuliighput
nuliigh[N][Abs][1SgPoss][DuPosd]	nuliighegka
nuliigh[N][Abs][1SgPoss][PlPosd]	nuliighenka
nuliigh[N][Abs][1SgPoss][SgPosd]	nuliiqa
nuyagh[N][Abs][1DuPoss][DuPosd]	nuyagpung
nuyagh[N][Abs][1DuPoss][PlPosd]	nuyapung
nuyagh[N][Abs][1DuPoss][SgPosd]	nuyaghpung
nuyagh[N][Abs][1PlPoss][DuPosd]	nuyagput
nuyagh[N][Abs][1PlPoss][PlPosd]	nuyaput
nuyagh[N][Abs][1PlPoss][SgPosd]	nuyaghput
nuyagh[N][Abs][1SgPoss][DuPosd]	nuyagka
nuyagh[N][Abs][1SgPoss][PlPosd]	nuyanka
nuyagh[N][Abs][1SgPoss][SgPosd]	nuyaqa
panig[N][Abs][1DuPoss][DuPosd]	panigegpung
panig[N][Abs][1DuPoss][PlPosd]	panipung
panig[N][Abs][1DuPoss][SgPosd]	panigpung
panig[N][Abs][1PlPoss][DuPosd]	panigegput
panig[N][Abs][1PlPoss][PlPosd]	paniput
panig[N][Abs][1PlPoss][SgPosd]	panigput
panig[N][Abs][1SgPoss][DuPosd]	panigegka
panig[N][Abs][1SgPoss][PlPosd]	panigenka
panig[N][Abs][1SgPoss][SgPosd]	panika
qiighw[N][Abs][1DuPoss][DuPosd]	qiighwegpung
qiighw[N][Abs][1DuPoss][PlPosd]	qiipung
qiighw[N][Abs][1DuPoss][SgPosd]	qiighwpung
qiighw[N][Abs][1PlPoss][DuPosd]	qiighwegput
qiighw[N][Abs][1PlPoss][PlPosd]	qiiput
qiighw[N][Abs][1PlPoss][SgPosd]	qiighwput
qiighw[N][Abs][1SgPoss][DuPosd]	qiighwegka
qiighw[N][Abs][1SgPoss][PlPosd]	qiighwenka
qiighw[N][Abs][1SgPoss][SgPosd]	qiiqwa
seghlegh[N][Abs][1DuPoss][DuPosd]	seghleghegpung
seghlegh[N][Abs][1DuPoss][PlPosd]	seghlepung
seghlegh[N][Abs][1DuPoss][SgPosd]	seghleghpung
seghlegh[N][Abs][1PlPoss][DuPosd]	seghleghegput
seghlegh[N][Abs][1PlPoss][PlPosd]	seghleput
seghlegh[N][Abs][1PlPoss][SgPosd]	seghleghput
seghlegh[N][Abs][1SgPoss][DuPosd]	seghleghegka
seghlegh[N][Abs][1SgPoss][PlPosd]	seghleghenka
seghlegh[N][Abs][1SgPoss][SgPosd]	seghleqa
sigute[N][Abs][1DuPoss][DuPosd]	sigutegpung
sigute[N][Abs][1DuPoss][PlPosd]	sigutepung
sigute[N][Abs][1DuPoss][SgPosd]	sigutevung
sigute[N][Abs][1PlPoss][DuPosd]	sigutegput
sigute[N][Abs][1PlPoss][PlPosd]	siguteput
sigute[N][Abs][1PlPoss][SgPosd]	sigutevut
sigute[N][Abs][1SgPoss][DuPosd]	sigutegka
sigute[N][Abs][1SgPoss][PlPosd]	sigutenka
sigute[N][Abs][1SgPoss][SgPosd]	sigutka
takestaaghhagh*[N][Abs][1DuPoss][DuPosd]	takestaaghhaagpung
takestaaghhagh*[N][Abs][1DuPoss][PlPosd]	takestaaghhapung
takestaaghhagh*[N][Abs][1DuPoss][SgPosd]	takestaaghhaghpung
takestaaghhagh*[N][Abs][1PlPoss][DuPosd]	takestaaghhaagput
takestaaghhagh*[N][Abs][1PlPoss][PlPosd]	takestaaghhaput
takestaaghhagh*[N][Abs][1PlPoss][SgPosd]	takestaaghhaghput
takestaaghhagh*[N][Abs][1SgPoss][DuPosd]	takestaaghhaagka
takestaaghhagh*[N][Abs][1SgPoss][PlPosd]	takestaaghhaanka
takestaaghhagh*[N][Abs][1SgPoss][SgPosd]	takestaaghhaqa
ugi[N][Abs][1DuPoss][DuPosd]	ugigpung
ugi[N][Abs][1DuPoss][PlPosd]	ugipung
ugi[N][Abs][1DuPoss][SgPosd]	ugivung
ugi[N][Abs][1PlPoss][DuPosd]	ugigput
ugi[N][Abs][1PlPoss][PlPosd]	ugiput
ugi[N][Abs][1PlPoss][SgPosd]	ugivut
ugi[N][Abs][1SgPoss][DuPosd]	ugigka
ugi[N][Abs][1SgPoss][PlPosd]	uginka
ugi[N][Abs][1SgPoss][SgPosd]	ugika
