atuqe[V][Trns][Ind][1Sg][2Sg]	atuqamken
atuqe[V][Trns][Ind][1Sg][3Pl]	atuqanka
atuqe[V][Trns][Ind][1Sg][3Sg]	atuqaqa
atuqe[V][Trns][Ind][2Sg][1Sg]	atuqapenga
atuqe[V][Trns][Ind][2Sg][3Pl]	atuqaten
atuqe[V][Trns][Ind][2Sg][3Sg]	atuqan
atuqe[V][Trns][Ind][3Pl][3Pl]	atuqiit
atuqe[V][Trns][Ind][3Pl][3Sg]	atuqaat
atuqe[V][Trns][Ind][3Sg][1Sg]	atuqaanga
atuqe[V][Trns][Ind][3Sg][2Sg]	atuqaaten
atuqe[V][Trns][Ind][3Sg][3Pl]	atuqii
atuqe[V][Trns][Ind][3Sg][3Sg]	atuqaa
aveg[V][Trns][Ind][1Sg][2Sg]	aavgamken
aveg[V][Trns][Ind][1Sg][3Pl]	aavganka
aveg[V][Trns][Ind][1Sg][3Sg]	aavgaqa
aveg[V][Trns][Ind][2Sg][1Sg]	aavgapenga
aveg[V][Trns][Ind][2Sg][3Pl]	aavgaten
aveg[V][Trns][Ind][2Sg][3Sg]	aavgan
aveg[V][Trns][Ind][3Pl][3Pl]	aavgiit
aveg[V][Trns][Ind][3Pl][3Sg]	aavgaat
aveg[V][Trns][Ind][3Sg][1Sg]	aavgaanga
aveg[V][Trns][Ind][3Sg][2Sg]	aavgaaten
aveg[V][Trns][Ind][3Sg][3Pl]	aavgii
aveg[V][Trns][Ind][3Sg][3Sg]	aavgaa
esghagh[V][Trns][Ind][1Sg][2Sg]	esghaghamken
esghagh[V][Trns][Ind][1Sg][3Pl]	esghaghanka
esghagh[V][Trns][Ind][1Sg][3Sg]	esghaghaqa
esghagh[V][Trns][Ind][2Sg][1Sg]	esghaghapenga
esghagh[V][Trns][Ind][2Sg][3Pl]	esghaghaten
esghagh[V][Trns][Ind][2Sg][3Sg]	esghaghan
esghagh[V][Trns][Ind][3Pl][3Pl]	esghaghiit
esghagh[V][Trns][Ind][3Pl][3Sg]	esghaghaat
esghagh[V][Trns][Ind][3Sg][1Sg]	esghaghaanga
esghagh[V][Trns][Ind][3Sg][2Sg]	esghaghaaten
esghagh[V][Trns][Ind][3Sg][3Pl]	esghaghii
esghagh[V][Trns][Ind][3Sg][3Sg]	esghaghaa
guute[V][Trns][Ind][1Sg][2Sg]	guutamken
guute[V][Trns][Ind][1Sg][3Pl]	guutanka
guute[V][Trns][Ind][1Sg][3Sg]	guutaqa
guute[V][Trns][Ind][2Sg][1Sg]	guutapenga
guute[V][Trns][Ind][2Sg][3Pl]	guutaten
guute[V][Trns][Ind][2Sg][3Sg]	guutan
guute[V][Trns][Ind][3Pl][3Pl]	guutiit
guute[V][Trns][Ind][3Pl][3Sg]	guutaat
guute[V][Trns][Ind][3Sg][1Sg]	guutaanga
guute[V][Trns][Ind][3Sg][2Sg]	guutaaten
guute[V][Trns][Ind][3Sg][3Pl]	guutii
guute[V][Trns][Ind][3Sg][3Sg]	guutaa
igamsiqayugvike[V][Trns][Ind][1Sg][2Sg]	igamsiqayugvikamken
igamsiqayugvike[V][Trns][Ind][1Sg][3Pl]	igamsiqayugvikanka
igamsiqayugvike[V][Trns][Ind][1Sg][3Sg]	igamsiqayugvikaqa
igamsiqayugvike[V][Trns][Ind][2Sg][1Sg]	igamsiqayugvikapenga
igamsiqayugvike[V][Trns][Ind][2Sg][3Pl]	igamsiqayugvikaten
igamsiqayugvike[V][Trns][Ind][2Sg][3Sg]	igamsiqayugvikan
igamsiqayugvike[V][Trns][Ind][3Pl][3Pl]	igamsiqayugvikiit
igamsiqayugvike[V][Trns][Ind][3Pl][3Sg]	igamsiqayugvikaat
igamsiqayugvike[V][Trns][Ind][3Sg][1Sg]	igamsiqayugvikaanga
igamsiqayugvike[V][Trns][Ind][3Sg][2Sg]	igamsiqayugvikaaten
igamsiqayugvike[V][Trns][Ind][3Sg][3Pl]	igamsiqayugvikii
igamsiqayugvike[V][Trns][Ind][3Sg][3Sg]	igamsiqayugvikaa
inghu[V][Trns][Ind][1Sg][2Sg]	inghwaamken
inghu[V][Trns][Ind][1Sg][3Pl]	inghwaanka
inghu[V][Trns][Ind][1Sg][3Sg]	inghwaaqa
inghu[V][Trns][Ind][2Sg][1Sg]	inghwaapenga
inghu[V][Trns][Ind][2Sg][3Pl]	inghwaaten
inghu[V][Trns][Ind][2Sg][3Sg]	inghwaan
inghu[V][Trns][Ind][3Pl][3Pl]	inghwiit
inghu[V][Trns][Ind][3Pl][3Sg]	inghwaat
inghu[V][Trns][Ind][3Sg][1Sg]	inghwaanga
inghu[V][Trns][Ind][3Sg][2Sg]	inghwaaten
inghu[V][Trns][Ind][3Sg][3Pl]	inghwii
inghu[V][Trns][Ind][3Sg][3Sg]	inghwaa
kuuve[V][Trns][Ind][1Sg][2Sg]	kuuvamken
kuuve[V][Trns][Ind][1Sg][3Pl]	kuuvanka
kuuve[V][Trns][Ind][1Sg][3Sg]	kuuvaqa
kuuve[V][Trns][Ind][2Sg][1Sg]	kuuvapenga
kuuve[V][Trns][Ind][2Sg][3Pl]	kuuvaten
kuuve[V][Trns][Ind][2Sg][3Sg]	kuuvan
kuuve[V][Trns][Ind][3Pl][3Pl]	kuuviit
kuuve[V][Trns][Ind][3Pl][3Sg]	kuuvaat
kuuve[V][Trns][Ind][3Sg][1Sg]	kuuvaanga
kuuve[V][Trns][Ind][3Sg][2Sg]	kuuvaaten
kuuve[V][Trns][Ind][3Sg][3Pl]	kuuvii
kuuve[V][Trns][Ind][3Sg][3Sg]	kuuvaa
laalighfike[V][Trns][Ind][1Sg][2Sg]	laalighfikamken
laalighfike[V][Trns][Ind][1Sg][3Pl]	laalighfikanka
laalighfike[V][Trns][Ind][1Sg][3Sg]	laalighfikaqa
laalighfike[V][Trns][Ind][2Sg][1Sg]	laalighfikapenga
laalighfike[V][Trns][Ind][2Sg][3Pl]	laalighfikaten
laalighfike[V][Trns][Ind][2Sg][3Sg]	laalighfikan
laalighfike[V][Trns][Ind][3Pl][3Pl]	laalighfikiit
laalighfike[V][Trns][Ind][3Pl][3Sg]	laalighfikaat
laalighfike[V][Trns][Ind][3Sg][1Sg]	laalighfikaanga
laalighfike[V][Trns][Ind][3Sg][2Sg]	laalighfikaaten
laalighfike[V][Trns][Ind][3Sg][3Pl]	laalighfikii
laalighfike[V][Trns][Ind][3Sg][3Sg]	laalighfikaa
liite[V][Trns][Ind][1Sg][2Sg]	liitamken
liite[V][Trns][Ind][1Sg][3Pl]	liitanka
liite[V][Trns][Ind][1Sg][3Sg]	liitaqa
liite[V][Trns][Ind][2Sg][1Sg]	liitapenga
liite[V][Trns][Ind][2Sg][3Pl]	liitaten
liite[V][Trns][Ind][2Sg][3Sg]	liitan
liite[V][Trns][Ind][3Pl][3Pl]	liitiit
liite[V][Trns][Ind][3Pl][3Sg]	liitaat
liite[V][Trns][Ind][3Sg][1Sg]	liitaanga
liite[V][Trns][Ind][3Sg][2Sg]	liitaaten
liite[V][Trns][Ind][3Sg][3Pl]	liitii
liite[V][Trns][Ind][3Sg][3Sg]	liitaa
lli[V][Trns][Ind][1Sg][2Sg]	lliimken
lli[V][Trns][Ind][1Sg][3Pl]	lliinka
lli[V][Trns][Ind][1Sg][3Sg]	lliiqa
lli[V][Trns][Ind][2Sg][1Sg]	lliipenga
lli[V][Trns][Ind][2Sg][3Pl]	lliiten
lli[V][Trns][Ind][2Sg][3Sg]	lliin
lli[V][Trns][Ind][3Pl][3Pl]	lliit
lli[V][Trns][Ind][3Pl][3Sg]	lliit
lli[V][Trns][Ind][3Sg][1Sg]	lliinga
lli[V][Trns][Ind][3Sg][2Sg]	lliiten
lli[V][Trns][Ind][3Sg][3Pl]	llii
lli[V][Trns][Ind][3Sg][3Sg]	llii
nalluke[V][Trns][Ind][1Sg][2Sg]	nallukamken
nalluke[V][Trns][Ind][1Sg][3Pl]	nallukanka
nalluke[V][Trns][Ind][1Sg][3Sg]	nallukaqa
nalluke[V][Trns][Ind][2Sg][1Sg]	nallukapenga
nalluke[V][Trns][Ind][2Sg][3Pl]	nallukaten
nalluke[V][Trns][Ind][2Sg][3Sg]	nallukan
nalluke[V][Trns][Ind][3Pl][3Pl]	nallukiit
nalluke[V][Trns][Ind][3Pl][3Sg]	nallukaat
nalluke[V][Trns][Ind][3Sg][1Sg]	nallukaanga
nalluke[V][Trns][Ind][3Sg][2Sg]	nallukaaten
nalluke[V][Trns][Ind][3Sg][3Pl]	nallukii
nalluke[V][Trns][Ind][3Sg][3Sg]	nallukaa
piniqe[V][Trns][Ind][1Sg][2Sg]	piniqamken
piniqe[V][Trns][Ind][1Sg][3Pl]	piniqanka
piniqe[V][Trns][Ind][1Sg][3Sg]	piniqaqa
piniqe[V][Trns][Ind][2Sg][1Sg]	piniqapenga
piniqe[V][Trns][Ind][2Sg][3Pl]	piniqaten
piniqe[V][Trns][Ind][2Sg][3Sg]	piniqan
piniqe[V][Trns][Ind][3Pl][3Pl]	piniqiit
piniqe[V][Trns][Ind][3Pl][3Sg]	piniqaat
piniqe[V][Trns][Ind][3Sg][1Sg]	piniqaanga
piniqe[V][Trns][Ind][3Sg][2Sg]	piniqaaten
piniqe[V][Trns][Ind][3Sg][3Pl]	piniqii
piniqe[V][Trns][Ind][3Sg][3Sg]	piniqaa
qelpeghte[V][Trns][Ind][1Sg][2Sg]	qelpeghtamken
qelpeghte[V][Trns][Ind][1Sg][3Pl]	qelpeghtanka
qelpeghte[V][Trns][Ind][1Sg][3Sg]	qelpeghtaqa
qelpeghte[V][Trns][Ind][2Sg][1Sg]	qelpeghtapenga
qelpeghte[V][Trns][Ind][2Sg][3Pl]	qelpeghtaten
qelpeghte[V][Trns][Ind][2Sg][3Sg]	qelpeghtan
qelpeghte[V][Trns][Ind][3Pl][3Pl]	qelpeghtiit
qelpeghte[V][Trns][Ind][3Pl][3Sg]	qelpeghtaat
qelpeghte[V][Trns][Ind][3Sg][1Sg]	qelpeghtaanga
qelpeghte[V][Trns][Ind][3Sg][2Sg]	qelpeghtaaten
qelpeghte[V][Trns][Ind][3Sg][3Pl]	qelpeghtii
qelpeghte[V][Trns][Ind][3Sg][3Sg]	qelpeghtaa
qilug[V][Trns][Ind][1Sg][2Sg]	qilugamken
qilug[V][Trns][Ind][1Sg][3Pl]	qiluganka
qilug[V][Trns][Ind][1Sg][3Sg]	qilugaqa
qilug[V][Trns][Ind][2Sg][1Sg]	qilugapenga
qilug[V][Trns][Ind][2Sg][3Pl]	qilugaten
qilug[V][Trns][Ind][2Sg][3Sg]	qilugan
qilug[V][Trns][Ind][3Pl][3Pl]	qilugiit
qilug[V][Trns][Ind][3Pl][3Sg]	qilugaat
qilug[V][Trns][Ind][3Sg][1Sg]	qilugaanga
qilug[V][Trns][Ind][3Sg][2Sg]	qilugaaten
qilug[V][Trns][Ind][3Sg][3Pl]	qilugii
qilug[V][Trns][Ind][3Sg][3Sg]	qilugaa
tugu[V][Trns][Ind][1Sg][2Sg]	tugaamken
tugu[V][Trns][Ind][1Sg][3Pl]	tugaanka
tugu[V][Trns][Ind][1Sg][3Sg]	tugaaqa
tugu[V][Trns][Ind][2Sg][1Sg]	tugaapenga
tugu[V][Trns][Ind][2Sg][3Pl]	tugaaten
tugu[V][Trns][Ind][2Sg][3Sg]	tugaan
tugu[V][Trns][Ind][3Pl][3Pl]	tugiit
tugu[V][Trns][Ind][3Pl][3Sg]	tugaat
tugu[V][Trns][Ind][3Sg][1Sg]	tugaanga
tugu[V][Trns][Ind][3Sg][2Sg]	tugaaten
tugu[V][Trns][Ind][3Sg][3Pl]	tugii
tugu[V][Trns][Ind][3Sg][3Sg]	tugaa
tuqute[V][Trns][Ind][1Sg][2Sg]	tuqutamken
tuqute[V][Trns][Ind][1Sg][3Pl]	tuqutanka
tuqute[V][Trns][Ind][1Sg][3Sg]	tuqutaqa
tuqute[V][Trns][Ind][2Sg][1Sg]	tuqutapenga
tuqute[V][Trns][Ind][2Sg][3Pl]	tuqutaten
tuqute[V][Trns][Ind][2Sg][3Sg]	tuqutan
tuqute[V][Trns][Ind][3Pl][3Pl]	tuqutiit
tuqute[V][Trns][Ind][3Pl][3Sg]	tuqutaat
tuqute[V][Trns][Ind][3Sg][1Sg]	tuqutaanga
tuqute[V][Trns][Ind][3Sg][2Sg]	tuqutaaten
tuqute[V][Trns][Ind][3Sg][3Pl]	tuqutii
tuqute[V][Trns][Ind][3Sg][3Sg]	tuqutaa
umeg[V][Trns][Ind][1Sg][2Sg]	uumgamken
umeg[V][Trns][Ind][1Sg][3Pl]	uumganka
umeg[V][Trns][Ind][1Sg][3Sg]	uumgaqa
umeg[V][Trns][Ind][2Sg][1Sg]	uumgapenga
umeg[V][Trns][Ind][2Sg][3Pl]	uumgaten
umeg[V][Trns][Ind][2Sg][3Sg]	uumgan
umeg[V][Trns][Ind][3Pl][3Pl]	uumgiit
umeg[V][Trns][Ind][3Pl][3Sg]	uumgaat
umeg[V][Trns][Ind][3Sg][1Sg]	uumgaanga
umeg[V][Trns][Ind][3Sg][2Sg]	uumgaaten
umeg[V][Trns][Ind][3Sg][3Pl]	uumgii
umeg[V][Trns][Ind][3Sg][3Sg]	uumgaa
